................................
..#..#....#..#...#..#..T.......T
..#..#....#..#..T.......T.....TT
....E.......E.......E.......E...
..T.......T.....#..#....#.E.....
..T.......T.....#...............
....#.......#.....T.......T.....
...E.......E.......E.......E....
..#.......#.......T.......T.....
.....T.......T.....E.......E....
